Akhiri: akhir
Akhirnya: akhir
Adalah: ada
Adanya: ada
Adapun: ada
Agar: agar
Akan: akan
Akhir: akhir
Aku: aku
Amat: amat
Antara: antara
Atas: atas
Awal: awal
Awalnya: awal
Bagaimana: bagaimana
Bahwa: bahwa
Baik: baik
Banyak: banyak
Bawah: bawah
Beberapa: beberapa
Begitu: begitu
Belakang: belakang
Belum: belum
Benar: benar
Benarkah: benar
Berada: ada
Berakhir: akhir
Berbagai: berbagai
Bersama: sama
Beserta: serta
Betul: betul
Biasa: biasa
Biasanya: biasa
Bila: bila
Bisa: bisa
Bukan: bukan
Bukankah: bukan
Bukannya: bukan
Cukup: cukup
Dahulu: dahulu
Dalam: dalam
Dan: dan
Dapat: dapat
Dari: dari
Daripada: dari
Demikian: demikian
Dengan: dengan
Di: di
Dia: dia
Diri: diri
Dirinya: diri
Dulu: dulu
Enggak: enggak
Hanya: hanya
Hingga: hingga
Ini: ini
Itu: itu
Jadi: jadi
Jangan: jangan
Jauh: jauh
Jika: jika
Juga: juga
Jumlah: jumlah
Kami: kami
Kamu: kamu
Karena: karena
Ke: ke
Kecil: kecil
Kedua: kedua
Kemudian: kemudian
Kembali: kembali
Kita: kita
Lagi: lagi
Lalu: lalu
Lama: lama
Lebih: lebih
Lima: lima
Luar: luar
Maka: maka
Makin: makin
Masih: masih
Mau: mau
Mereka: mereka
Meski: meski
Namun: namun
Nanti: nanti
Oleh: oleh
Pada: pada
Paling: paling
Para: para
Pasti: pasti
Saat: saat
Saja: saja
Saling: saling
Sama: sama
Sampai: sampai
Sangat: sangat
Saya: saya
Seperti: seperti
Sudah: sudah
Supaya: supaya
Tadi: tadi
Tahu: tahu
Tanpa: tanpa
Tapi: tapi
Tentang: tentang
Tentu: tentu
Tidak: tidak
Untuk: untuk
Walau: walau
Walaupun: walau
Yang: yang